1111111111111111
1000C00010110001
11101111001E1011
1000000000000001
1P000C1000100001
1111111111111111
1111111111111111