1111111111111
10000000100C1
10P00010000E1
1111111111111
