1111111111111
1000C00010001
10100010C00E1
1000010000001
1P000C100C101
1111111111111
