1111111111111111
1000C00010110001
10100010C01E0C11
1000010000000001
1P000C100C100001
1111111111111111
