1111111111111111
1000C00010110001
11110111C01E1C11
1000000000000001
1P000C100C100001
1111111111111111
