11111111111111111
1000000010110001
11110111001E1011
1000000000000001
1P000C1000100001
1111111111111111
111111111111111111111