1111111111111111111
1000C1001100C111111
1C10000000001C11111
111C110P0C000011111
100000C100000111111
1E110001C0C00011111
101000C00000C011111
1111111111111111111