111111111111111
1000C1001100C11
1C10000000001C1
111C110P0C00001
100000C10000011
1E110001C0C0001
101000C00000C01
111111111111111