111111111111111
1000C1001100C11
1C10000000001C1
111C11000C00001
1P0000C10000011
11110001C0C0001
1E0000C00000C01
111111111111111