111111111111111111
100000000001001C11
100000011100000001
1000P0000001100111
100010001C10010111
1000001E1100000011
111111111111111111